    x x   
x x x   x 
x x   x x 
xx  xx   x
 x x  xxxx
 x  x    x
  x   xxx 
x   x     