    x x      
x x x   x xx 
x x   x x x  
xx  xx   x  x
 x x  xxxx xx
 x  x   x  xx
  x   xxxx  x
x   x x   x  
xx xx   x x x
 x xxxxxx x  
 x         x 
 xxxxxxxxxxx 
             